WWWWWWWWWWWWWWWWWWWWWWWWWWWWWWW
W     W     W       W         W
W   WWW     WW          WWWWWWW
W   W    W   WW WWWWW      W  W
W   W    W   WW  W         W  W
W   W   WW    WW WWWWWW  WWWW W
W  WW   WW    W       W   W   W
W       W             W   W WWWW
W       W   E         W  W  WWW
W       W             WAW   WWW
WWWWWWWWWWWWWWWWWWWWWWWW WWWWWW